Fonts 5:
Code: Aeon
Gimmicks: Aeon, Anumania
UI, modified noteskins, misc. graphics: Aeon
Maps: Aeon
Map support: Anumania
Title theme: jaerockets
Concept: Aeon, Anumania, Yunevii
Testing: Aeon, Anumania, Yunevii

Software/code:
GameMaker Studio 1.4 - Game engine
StepMania - Mapping tool, original concept
YellowAfterLife - Custom cursor GameMaker extension
Paint.NET - All visual edits
Aseprite - Original sprites
SpriteStack - Spinning world
FireAlpaca - When I needed cool brush effects
GitKraken - Git client
GitHub - Git host
Windows 10 - OS
getsongbpm.com - Getting song bpm
anything2mp3.cc - Downloading the songs I didn't already have
Notepad - This text document
Wordpad - The prologue text document
Audacity - Cutting Nocturne
Notepad++ - Copying .sm files and making StepMania versions of noteskins work
Pixel FX Designer - The yellow effect on the world in story mode
Newgrounds, itch.io, X10 Hosting, Mega.nz - Hosting, unless one of them says I can't because it contains "copyrighted material"
Steven Dall - GameMaker StepMania library that I didn't use
GMLscripts.com - collision_line_first
Peter "tehwave" JÃ¸rgensen - draw_circle_width

Visuals:
Jousway - midi-solo noteskin
Toby Fox - SOUL sprite, lancer raps BG
Artyom Samoilov - ZERO sprites
World of Warcraft - Night of Past BG
Tech N9ne - lancer raps BG
Touru Amamiya - Reset Set BG
Porter Robinson - Key BG
Porter Robinson - Eon Break BG
I don't know who made the - chromatic judgement font

Music:
Night of Past: reach (involving:) SiIvagunner, Gerard Butler, keatonkeaton999, O-Zone, Kohmi Hirose, kors k, Jonathan Wolff, Eino Kettunen, Loituma, Hatsune Miku, beatMARIO, Nitori Kawashiro, Unregistered HyperCam 2
lancer raps: Galactic Hole (involving:) Toby Fox (DELTARUNE), Tech N9ne, Spongebob Squarepants
Night Falls ~ Evening Star: ELEMENTAS (Touhou Hyouibana ~ Antinomy of Common Flowers)
Everything will freeze: UNDEAD CORPORATION (BOUKUN)
Nocturne: Bill Kiley (Katana ZERO)
Reset Set: Nanawo Akari (Shichiten Nanaki)
Key: Porter Robinson (Virtual Self)
Eon Break: Porter Robinson (Virtual Self)
It's Raining Somewhere Else: Toby Fox (UNDERTALE)
Yume ga aru: Yugo Kanno, Kensho Ono, Atsushi Miyauchi, Giorno Giovanna (Vento Aureo)
Title: Jaerockets
Menu: A user from freesound.org that I am unable to locate again.

Special Thanks:
PeanutButterGamer
Lunatic Red Touhou forums
Shoujo Shuumatsu Ryokou
The guy who translated Reset Set
Heats Flamesman
The travelers